WWWWWWWWWWWWWW
WFFFFFFFFFFFWW
WFWWWWWWWWFFWW
WFFFFFFFFWFFWW
WFFWWFsFFWsFWW
WFFFWFFFFWWWWW
WFFFWWWgWsFFWW
WpFFFFWgWFFFWW
WFFWWWWgWWWFWW
WFFWFFFFWFFFWW
WFFFFFWFFFFWWW
WWWWWWWWWWWWWW
